11111111111111111111111
1C000000000X00100000001
1000000000000000000C001
11011100C0111100C000001
1E00000000111100000C001
111111110C011100P000001
1000XXX0000001000000001
10C00000000001000X00001
11011100C0111100000C001
10000000000C00000000001
11111111111111111111111
